000000000000002022220000000000000000000000000000000
000000000000002002020000000000000000000000000000000
000000000000020000000000000000000000000000000000000
000000000000200020200000000000000000000000000000000
000000000000000000200000000000000000000000000000000
000000000002200000000000000000020000000000000000000
000000000002020002000022220202200000000000000000000
000000000022000000000200000000000022020000000000000
000000000000000020002000000000002000020000000000000
000000000022000000020000000000200002000000000000000
000000000000002000000000000000000000000000000000000
000000000220202002220020020020020022000200200000000
000000000220220000000000000200000000000000000200200
000000002220220002000000000000000200000000000000002
000000020022000002000000200000000000000000000000000
000000000000000000000000000000000000000000000000000
000000020220000020020020000000002000000000000000000
000000022002000000000020022220000000000000000000000
022200000000000000020002222222000000000000000000000
200022000000200000000022220002200000000000000000000
000002200000000020000200000000220020022000000000000
200000220000002002022002000000220020000000000000000
200000000000000000020020000022000000000000000000000
000020020000002020020000002000020000000000000000000
000000002000000000020200002000000000000000000000000
202000000200000000200002000000020000000000000000002
200000000200200000202200000000000000000000000000000
000000000002020000200000020000000000000000000000200
020000000200000002200000200000020000000000000000000
200000000200000000220002000220002022002000000000000
200000000200200000000000000000200222020000000020000
000000000000000000000000000000000000000000000000000
200000002200002002000200000200220200000000000000000
000000000200000002002020020002000000000000020000000
000000022000200002200000000200000000000000000000000
000000000000200000002000200000202000000200000000000
000000000000000000000000000000020000000000000000000
000000000200200000200020000000000002000000000000000
000000000000000000002000000000200020000000000000000
000000020000200020200000000000002020002200000000000
000000000000002000000000000002200002020200000000000
000000000000020020000000000020000022000200000000000
000000200000222000000000020020000200002000000000000
000000000002200020000000000000000000020000000000000
000020000000000000202020000202000002000000000000000
000000000000000000000000000200000020000000000000000
000200000000000000000000000200000200000000000000000
000000000000000000000000000222222000000000000000000
000000000000000000000000000000000000000000000000000
000000000000000000000000000000000000000000000000000